########
#....#.#
#.##.#.#
#.#..#.#
#.#.##.#
#......#
#.####.#
########
